"aq" = (/obj/structure/stairs{dir = 4; icon_state = "stairs"},/turf/open/floor/rogue/naturalstone,/area/science/xenobiology{requires_power = 0; name = "Secret Lab"})
"aw" = (/obj/structure/holosign/barrier,/turf/open/floor/plasteel/maniac,/area/rogue)
"az" = (/obj/effect/decal/cleanable/blood,/obj/effect/decal/cleanable/blood/innards,/turf/open/transparent/glass,/area/rogue)
"ba" = (/obj/effect/decal/cleanable/blood,/obj/effect/decal/cleanable/blood/gibs/body,/turf/open/transparent/glass,/area/rogue)
"be" = (/obj/effect/decal/cleanable/blood/gibs,/turf/open/floor/plasteel/maniac,/area/science/xenobiology{requires_power = 0; name = "Secret Lab"})
"bT" = (/mob/living/simple_animal/hostile/retaliate/rogue/orc/orc_marauder/ravager,/turf/open/floor/rogue/naturalstone,/area/science/xenobiology{requires_power = 0; name = "Secret Lab"})
"bZ" = (/obj/machinery/light/floor,/turf/open/floor/plasteel/maniac,/area/science/xenobiology{requires_power = 0; name = "Secret Lab"})
"cg" = (/obj/structure/table/greyscale,/obj/machinery/microwave,/turf/open/floor/plasteel/maniac,/area/science/xenobiology{requires_power = 0; name = "Secret Lab"})
"cr" = (/obj/structure/showcase/machinery/microwave,/turf/open/floor/plasteel/maniac,/area/science/xenobiology{requires_power = 0; name = "Secret Lab"})
"cA" = (/obj/effect/decal/cleanable/blood/gibs/down,/mob/living/simple_animal/hostile/retaliate/spaceman,/turf/open/floor/plasteel/maniac,/area/science/xenobiology{requires_power = 0; name = "Secret Lab"})
"cP" = (/obj/structure/stairs{dir = 8; icon_state = "stairs"},/turf/open/transparent/openspace,/area/rogue)
"dm" = (/mob/living/simple_animal/hostile/retaliate/rogue/orc/orc_marauder,/turf/open/floor/plasteel/maniac,/area/science/xenobiology{requires_power = 0; name = "Secret Lab"})
"dn" = (/obj/structure/chair/greyscale{dir = 1},/mob/living/simple_animal/hostile/retaliate/rogue/orc/spear,/turf/open/floor/plasteel/maniac,/area/science/xenobiology{requires_power = 0; name = "Secret Lab"})
"dv" = (/obj/structure/closet/crate/trashcart,/obj/item/organ/eyes/robotic/thermals,/turf/open/floor/plasteel/maniac,/area/rogue)
"dw" = (/obj/structure/closet/crate/chest,/obj/effect/spawner/lootdrop/roguetown/dungeon/spells,/obj/effect/spawner/lootdrop/roguetown/dungeon/misc,/obj/effect/spawner/lootdrop/roguetown/dungeon/misc,/turf/open/floor/plasteel/maniac,/area/science/xenobiology{requires_power = 0; name = "Secret Lab"})
"dD" = (/obj/structure/sign/poster/official/no_erp,/turf/closed/wall/mineral/rogue/pipe,/area/science/xenobiology{requires_power = 0; name = "Secret Lab"})
"ew" = (/obj/machinery/vending/snack/blue,/turf/open/floor/plasteel/maniac,/area/science/xenobiology{requires_power = 0; name = "Secret Lab"})
"ez" = (/obj/effect/decal/cleanable/blood,/turf/open/transparent/glass,/area/rogue)
"fu" = (/mob/living/simple_animal/hostile/retaliate/rogue/orc/ranged,/turf/open/floor/plasteel/maniac,/area/science/xenobiology{requires_power = 0; name = "Secret Lab"})
"fy" = (/obj/machinery/light/floor,/obj/effect/decal/cleanable/blood,/turf/open/floor/plasteel/maniac,/area/science/xenobiology{requires_power = 0; name = "Secret Lab"})
"fT" = (/turf/open/water/bath,/area/rogue)
"fX" = (/obj/structure/table/greyscale,/obj/item/book/granter/spell/blackstone/skeleton,/turf/open/floor/plasteel/maniac,/area/science/xenobiology{requires_power = 0; name = "Secret Lab"})
"gl" = (/obj/effect/decal/cleanable/blood/splatter,/turf/open/floor/plasteel/maniac,/area/science/xenobiology{requires_power = 0; name = "Secret Lab"})
"go" = (/mob/living/simple_animal/hostile/retaliate/rogue/orc/spear2,/turf/open/floor/plasteel/maniac,/area/science/xenobiology{requires_power = 0; name = "Secret Lab"})
"gJ" = (/mob/living/simple_animal/hostile/retaliate/rogue/orc,/turf/open/floor/rogue/naturalstone,/area/rogue)
"gY" = (/obj/effect/decal/cleanable/blood/gibs/body,/obj/effect/spawner/lootdrop/roguetown/dungeon/materials,/obj/effect/spawner/lootdrop/roguetown/dungeon/materials,/obj/effect/spawner/lootdrop/roguetown/dungeon/materials,/obj/effect/spawner/lootdrop/roguetown/dungeon/materials,/obj/structure/closet/crate/chest,/turf/open/floor/plasteel/maniac,/area/science/xenobiology{requires_power = 0; name = "Secret Lab"})
"gZ" = (/obj/structure/chair/greyscale{dir = 1},/turf/open/floor/plasteel/maniac,/area/science/xenobiology{requires_power = 0; name = "Secret Lab"})
"hr" = (/obj/structure/chair/greyscale,/turf/open/floor/plasteel/maniac,/area/science/xenobiology{requires_power = 0; name = "Secret Lab"})
"hu" = (/obj/structure/closet/crate,/obj/effect/spawner/lootdrop/pizzaparty,/turf/open/floor/plasteel/maniac,/area/science/xenobiology{requires_power = 0; name = "Secret Lab"})
"hX" = (/obj/item/chair{dir = 4},/turf/open/floor/plasteel/maniac,/area/science/xenobiology{requires_power = 0; name = "Secret Lab"})
"ix" = (/obj/item/crowbar/large,/obj/effect/decal/cleanable/blood,/turf/open/floor/rogue/naturalstone,/area/science/xenobiology{requires_power = 0; name = "Secret Lab"})
"iG" = (/obj/effect/decal/cleanable/blood/gibs/down,/turf/open/floor/plasteel/maniac,/area/science/xenobiology{requires_power = 0; name = "Secret Lab"})
"jq" = (/turf/closed/wall/mineral/rogue/pipe,/area/science/xenobiology{requires_power = 0; name = "Secret Lab"})
"jT" = (/obj/effect/mob_spawn/human/orc/corpse/savageorc2,/turf/open/floor/plasteel/maniac,/area/rogue)
"kq" = (/mob/living/simple_animal/hostile/retaliate/rogue/orc/ranged,/turf/open/floor/rogue/naturalstone,/area/rogue)
"kC" = (/turf/open/floor/plasteel/maniac,/area/science/xenobiology{requires_power = 0; name = "Secret Lab"})
"kD" = (/obj/machinery/light/floor,/obj/effect/decal/cleanable/blood/gibs,/obj/effect/spawner/lootdrop/roguetown/dungeon/misc,/obj/effect/spawner/lootdrop/roguetown/dungeon/misc,/obj/effect/spawner/lootdrop/roguetown/dungeon/misc,/obj/effect/spawner/lootdrop/roguetown/dungeon/misc,/obj/structure/closet/crate/chest,/turf/open/floor/plasteel/maniac,/area/science/xenobiology{requires_power = 0; name = "Secret Lab"})
"li" = (/obj/machinery/light/floor,/obj/effect/turf_decal/stripes/line{dir = 1},/obj/effect/decal/cleanable/blood/old,/turf/open/floor/plasteel/maniac,/area/science/xenobiology{requires_power = 0; name = "Secret Lab"})
"mP" = (/obj/structure/sign/warning/nosmoking,/turf/closed/wall/mineral/rogue/pipe,/area/science/xenobiology{requires_power = 0; name = "Secret Lab"})
"mV" = (/obj/effect/decal/cleanable/blood,/obj/machinery/porta_turret/syndicate/energy/heavy,/turf/open/floor/plasteel/maniac,/area/science/xenobiology{requires_power = 0; name = "Secret Lab"})
"mW" = (/obj/effect/mob_spawn/human/orc/corpse/savageorc,/turf/open/floor/plasteel/maniac,/area/science/xenobiology{requires_power = 0; name = "Secret Lab"})
"nd" = (/obj/structure/sign/warning/biohazard,/turf/closed/wall/mineral/rogue/pipe,/area/science/xenobiology{requires_power = 0; name = "Secret Lab"})
"nL" = (/obj/structure/rack,/obj/item/roguestatue/gold/loot,/turf/open/floor/plasteel/maniac,/area/science/xenobiology{requires_power = 0; name = "Secret Lab"})
"oF" = (/obj/machinery/door/airlock/highsecurity,/turf/open/floor/plasteel/maniac,/area/science/xenobiology{requires_power = 0; name = "Secret Lab"})
"oH" = (/obj/structure/closet/crate/chest,/obj/effect/spawner/lootdrop/roguetown/dungeon/food,/obj/effect/spawner/lootdrop/roguetown/dungeon/food,/obj/effect/spawner/lootdrop/roguetown/dungeon/medical,/turf/open/floor/rogue/naturalstone,/area/rogue)
"pT" = (/obj/effect/mob_spawn/human/orc/corpse/savageorc,/obj/effect/spawner/lootdrop/grille_or_trash,/turf/open/floor/plasteel/maniac,/area/science/xenobiology{requires_power = 0; name = "Secret Lab"})
"qw" = (/obj/structure/rack,/obj/item/book/manual/wiki/experimentor{pixel_x = 9},/obj/item/book/manual/wiki/research_and_development{pixel_x = 4},/obj/item/book/manual/wiki/telescience{pixel_x = -7},/turf/open/floor/plasteel/maniac,/area/science/xenobiology{requires_power = 0; name = "Secret Lab"})
"sb" = (/mob/living/simple_animal/hostile/retaliate/rogue/orc/spear,/turf/open/floor/plasteel/maniac,/area/science/xenobiology{requires_power = 0; name = "Secret Lab"})
"sm" = (/obj/effect/decal/cleanable/blood/gibs/core,/turf/open/floor/plasteel/maniac,/area/rogue)
"sn" = (/obj/structure/table/greyscale,/obj/item/reagent_containers/glass/bottle/rogue/healthpot,/obj/item/reagent_containers/glass/bottle/rogue/poison{pixel_y = 2; pixel_x = 7},/obj/item/reagent_containers/glass/bottle/rogue/wine{pixel_x = 11; pixel_y = -3},/turf/open/floor/plasteel/maniac,/area/science/xenobiology{requires_power = 0; name = "Secret Lab"})
"sA" = (/obj/effect/spawner/lootdrop/roguetown/dungeon/money,/turf/open/floor/rogue/naturalstone,/area/rogue)
"sE" = (/obj/structure/stairs{dir = 4; icon_state = "stairs"},/turf/open/floor/rogue/naturalstone,/area/rogue)
"tf" = (/obj/effect/decal/cleanable/blood/gibs/up,/turf/open/floor/plasteel/maniac,/area/rogue)
"tg" = (/obj/effect/decal/cleanable/blood/gibs/up,/mob/living/simple_animal/hostile/retaliate/spaceman,/turf/open/floor/plasteel/maniac,/area/science/xenobiology{requires_power = 0; name = "Secret Lab"})
"us" = (/mob/living/simple_animal/hostile/retaliate/spaceman,/turf/open/floor/plasteel/maniac,/area/science/xenobiology{requires_power = 0; name = "Secret Lab"})
"uE" = (/obj/structure/sign/poster/official/help_others,/turf/closed/wall/mineral/rogue/pipe,/area/science/xenobiology{requires_power = 0; name = "Secret Lab"})
"uP" = (/turf/open/water/cleanshallow,/area/rogue)
"vT" = (/obj/structure/closet/crate,/obj/effect/spawner/lootdrop/maintenance/five,/turf/open/floor/plasteel/maniac,/area/science/xenobiology{requires_power = 0; name = "Secret Lab"})
"vU" = (/obj/effect/decal/cleanable/blood/gibs,/obj/effect/decal/cleanable/blood,/turf/open/floor/plasteel/maniac,/area/science/xenobiology{requires_power = 0; name = "Secret Lab"})
"wK" = (/obj/structure/closet/crate/chest/lootbox,/obj/effect/spawner/lootdrop/roguetown/dungeon/money,/obj/effect/spawner/lootdrop/roguetown/dungeon/money,/obj/effect/spawner/lootdrop/roguetown/dungeon/money,/obj/effect/spawner/lootdrop/roguetown/dungeon/money,/turf/open/floor/plasteel/maniac,/area/rogue)
"xq" = (/obj/structure/table/greyscale,/obj/item/book/rogue/necra{pixel_x = 11; pixel_y = -9},/obj/item/book/rogue/festus{pixel_x = 10; pixel_y = 2},/obj/item/book/rogue/beardling,/turf/open/floor/plasteel/maniac,/area/science/xenobiology{requires_power = 0; name = "Secret Lab"})
"xK" = (/obj/structure/sign/warning/securearea{name = "Unknown Sign"},/turf/closed/wall/mineral/rogue/pipe,/area/science/xenobiology{requires_power = 0; name = "Secret Lab"})
"yq" = (/mob/living/simple_animal/hostile/retaliate/rogue/orc/spear2,/turf/open/floor/rogue/naturalstone,/area/rogue)
"zd" = (/obj/effect/decal/cleanable/blood,/obj/effect/mob_spawn/human/orc/corpse/savageorc,/turf/open/floor/plasteel/maniac,/area/science/xenobiology{requires_power = 0; name = "Secret Lab"})
"zg" = (/turf/closed/mineral/random/rogue,/area/rogue)
"zp" = (/obj/item/twohanded/required/kirbyplants{icon_state = "plant-10"},/turf/open/floor/plasteel/maniac,/area/rogue)
"zJ" = (/turf/open/floor/grass,/area/rogue)
"AE" = (/obj/item/chair,/turf/open/floor/plasteel/maniac,/area/science/xenobiology{requires_power = 0; name = "Secret Lab"})
"Bo" = (/turf/open/transparent/glass,/area/rogue)
"Ci" = (/obj/structure/table/greyscale,/obj/item/reagent_containers/food/drinks/soda_cans/cola{pixel_x = 7},/obj/item/reagent_containers/food/snacks/spacetwinkie{pixel_y = -1; pixel_x = -5},/turf/open/floor/plasteel/maniac,/area/science/xenobiology{requires_power = 0; name = "Secret Lab"})
"CE" = (/obj/structure/rack,/obj/item/wirecutters,/turf/open/floor/plasteel/maniac,/area/science/xenobiology{requires_power = 0; name = "Secret Lab"})
"CF" = (/obj/machinery/porta_turret/syndicate/energy/heavy,/turf/open/floor/plasteel/maniac,/area/science/xenobiology{requires_power = 0; name = "Secret Lab"})
"CI" = (/mob/living/simple_animal/hostile/retaliate/spaceman,/mob/living/simple_animal/hostile/retaliate/spaceman,/turf/open/floor/plasteel/maniac,/area/science/xenobiology{requires_power = 0; name = "Secret Lab"})
"CP" = (/obj/machinery/light/floor,/mob/living/simple_animal/hostile/retaliate/spaceman,/mob/living/simple_animal/hostile/retaliate/spaceman,/turf/open/floor/plasteel/maniac,/area/science/xenobiology{requires_power = 0; name = "Secret Lab"})
"Dj" = (/obj/structure/showcase/horrific_experiment,/mob/living/simple_animal/hostile/retaliate/spaceman,/turf/open/floor/plasteel/maniac,/area/science/xenobiology{requires_power = 0; name = "Secret Lab"})
"Ds" = (/obj/machinery/power/port_gen/pacman/super,/turf/open/floor/plasteel/maniac,/area/science/xenobiology{requires_power = 0; name = "Secret Lab"})
"Ea" = (/obj/effect/mob_spawn/human/orc/corpse/savageorc,/turf/open/water/bath,/area/rogue)
"Ew" = (/obj/structure/table/greyscale,/obj/item/paper/natural{pixel_x = 6; pixel_y = -7},/obj/item/pen{pixel_y = 12; pixel_x = -9},/turf/open/floor/plasteel/maniac,/area/science/xenobiology{requires_power = 0; name = "Secret Lab"})
"EP" = (/obj/effect/decal/cleanable/blood/gibs,/obj/effect/decal/cleanable/blood,/obj/effect/mob_spawn/human/orc/corpse/savageorc,/turf/open/floor/plasteel/maniac,/area/science/xenobiology{requires_power = 0; name = "Secret Lab"})
"Fj" = (/obj/structure/closet/crate/chest/lootbox,/obj/effect/spawner/lootdrop/roguetown/dungeon/armor,/obj/effect/spawner/lootdrop/roguetown/dungeon/armor,/obj/effect/spawner/lootdrop/roguetown/dungeon/weapons,/obj/effect/spawner/lootdrop/roguetown/dungeon/weapons,/turf/open/floor/plasteel/maniac,/area/science/xenobiology{requires_power = 0; name = "Secret Lab"})
"FA" = (/turf/closed/mineral/rogue/bedrock,/area/rogue)
"FB" = (/obj/effect/decal/cleanable/blood,/obj/effect/decal/cleanable/blood/gibs/up,/turf/open/transparent/glass,/area/rogue)
"FC" = (/turf/open/floor/rogue/naturalstone,/area/rogue)
"FV" = (/mob/living/simple_animal/hostile/syndicate/melee/sword/space/stormtrooper{health = 500; name = "John Syndicate"; speak_chance = 1; speak = list("...", "Wake up.", "Free me from the system, or kill me."); speed = 2; speak_emote = list("says"); STASTR = 30; STASPD = 20; STALUC = 15; STAPER = 20; STAEND = 20; STACON = 20; canparry = 1},/turf/open/transparent/glass,/area/rogue)
"Gh" = (/turf/closed/wall/mineral/rogue/pipe{dir = 4; icon_state = "iron_line"},/area/science/xenobiology{requires_power = 0; name = "Secret Lab"})
"Gm" = (/obj/machinery/light/floor,/mob/living/simple_animal/hostile/stickman/dog,/obj/effect/mob_spawn/human/orc/corpse/savageorc,/turf/open/floor/plasteel/maniac,/area/science/xenobiology{requires_power = 0; name = "Secret Lab"})
"Gq" = (/obj/effect/decal/cleanable/blood,/obj/structure/fluff/empty_cryostasis_sleeper,/mob/living/simple_animal/hostile/retaliate/spaceman,/mob/living/simple_animal/hostile/retaliate/spaceman,/turf/open/floor/plasteel/maniac,/area/science/xenobiology{requires_power = 0; name = "Secret Lab"})
"GM" = (/obj/effect/decal/cleanable/blood/gibs/up,/turf/open/floor/plasteel/maniac,/area/science/xenobiology{requires_power = 0; name = "Secret Lab"})
"HG" = (/obj/machinery/door/airlock/highsecurity,/turf/open/floor/plasteel/maniac,/area/rogue)
"IA" = (/obj/machinery/limbgrower,/turf/open/floor/plasteel/maniac,/area/science/xenobiology{requires_power = 0; name = "Secret Lab"})
"JS" = (/obj/effect/decal/cleanable/blood/gibs/body,/mob/living/simple_animal/hostile/retaliate/spaceman,/mob/living/simple_animal/hostile/retaliate/spaceman,/turf/open/floor/plasteel/maniac,/area/science/xenobiology{requires_power = 0; name = "Secret Lab"})
"Kn" = (/mob/living/simple_animal/hostile/retaliate/rogue/orc/orc_marauder/spear,/turf/open/floor/plasteel/maniac,/area/science/xenobiology{requires_power = 0; name = "Secret Lab"})
"KY" = (/turf/open/transparent/openspace,/area/rogue)
"LF" = (/obj/effect/decal/cleanable/blood,/obj/effect/decal/cleanable/blood/gibs,/turf/open/floor/plasteel/maniac,/area/science/xenobiology{requires_power = 0; name = "Secret Lab"})
"LJ" = (/obj/structure/sign/poster/contraband/fun_police,/turf/closed/wall/mineral/rogue/pipe,/area/science/xenobiology{requires_power = 0; name = "Secret Lab"})
"Mt" = (/obj/structure/closet/crate/chest/lootbox,/obj/effect/spawner/lootdrop/roguetown/dungeon/medical,/obj/effect/spawner/lootdrop/roguetown/dungeon/medical,/obj/effect/spawner/lootdrop/roguetown/dungeon/medical,/turf/open/floor/plasteel/maniac,/area/rogue)
"MR" = (/obj/effect/decal/cleanable/blood,/mob/living/simple_animal/hostile/retaliate/rogue/orc/spear,/turf/open/floor/plasteel/maniac,/area/science/xenobiology{requires_power = 0; name = "Secret Lab"})
"MX" = (/obj/structure/chair/greyscale,/obj/effect/decal/cleanable/blood/gibs/body,/turf/open/floor/plasteel/maniac,/area/science/xenobiology{requires_power = 0; name = "Secret Lab"})
"NN" = (/obj/effect/decal/cleanable/blood/innards,/obj/effect/decal/cleanable/vomit,/mob/living/simple_animal/hostile/retaliate/spaceman,/turf/open/floor/plasteel/maniac,/area/science/xenobiology{requires_power = 0; name = "Secret Lab"})
"Oh" = (/obj/effect/decal/cleanable/blood/gibs,/mob/living/simple_animal/hostile/retaliate/spaceman,/turf/open/floor/plasteel/maniac,/area/science/xenobiology{requires_power = 0; name = "Secret Lab"})
"Or" = (/obj/structure/table/greyscale,/obj/machinery/reagentgrinder{pixel_x = 6},/turf/open/floor/plasteel/maniac,/area/science/xenobiology{requires_power = 0; name = "Secret Lab"})
"OR" = (/obj/effect/decal/cleanable/blood/old,/mob/living/simple_animal/hostile/retaliate/spaceman,/turf/open/floor/plasteel/maniac,/area/science/xenobiology{requires_power = 0; name = "Secret Lab"})
"OT" = (/obj/effect/decal/cleanable/blood/gibs,/turf/open/transparent/glass,/area/rogue)
"Pq" = (/obj/effect/decal/cleanable/blood/gibs/body,/turf/open/transparent/glass,/area/rogue)
"Pr" = (/obj/structure/table/greyscale,/obj/item/book/rogue/sword{pixel_y = -4; pixel_x = 10},/obj/item/book/rogue/law{pixel_y = -5; pixel_x = -4},/turf/open/floor/plasteel/maniac,/area/science/xenobiology{requires_power = 0; name = "Secret Lab"})
"Pt" = (/obj/effect/decal/cleanable/blood/gibs/body,/obj/effect/mob_spawn/human/orc/corpse/orcmarauder,/turf/open/floor/plasteel/maniac,/area/science/xenobiology{requires_power = 0; name = "Secret Lab"})
"PE" = (/obj/effect/decal/cleanable/blood,/turf/open/floor/plasteel/maniac,/area/science/xenobiology{requires_power = 0; name = "Secret Lab"})
"Qq" = (/obj/effect/mob_spawn/human/orc/corpse/orcmarauder,/turf/open/water/bath,/area/rogue)
"Qy" = (/obj/effect/decal/cleanable/blood,/obj/effect/mob_spawn/human/orc/corpse/orcravager,/turf/open/transparent/glass,/area/rogue)
"Ra" = (/obj/structure/rack,/obj/item/poster/random_official,/obj/item/poster/random_official,/obj/item/poster/random_official,/obj/item/poster/random_official,/obj/item/poster/random_official,/turf/open/floor/plasteel/maniac,/area/science/xenobiology{requires_power = 0; name = "Secret Lab"})
"RJ" = (/obj/effect/mob_spawn/human/orc/corpse/orcmarauder,/turf/open/floor/plasteel/maniac,/area/science/xenobiology{requires_power = 0; name = "Secret Lab"})
"Sa" = (/obj/effect/decal/cleanable/blood,/obj/effect/decal/cleanable/blood/gibs/up,/turf/open/floor/plasteel/maniac,/area/science/xenobiology{requires_power = 0; name = "Secret Lab"})
"SQ" = (/mob/living/simple_animal/hostile/retaliate/rogue/orc/orc2,/turf/open/floor/rogue/naturalstone,/area/rogue)
"Tl" = (/obj/structure/stairs{dir = 4; icon_state = "stairs"},/obj/structure/stairs{dir = 4; icon_state = "stairs"},/mob/living/simple_animal/hostile/retaliate/rogue/orc/orc_marauder/ravager,/turf/open/floor/rogue/naturalstone,/area/science/xenobiology{requires_power = 0; name = "Secret Lab"})
"TQ" = (/turf/closed/wall/mineral/rogue/pipe,/area/rogue)
"Uy" = (/obj/effect/spawner/lootdrop/roguetown/sewers,/turf/open/floor/rogue/naturalstone,/area/rogue)
"VH" = (/obj/machinery/light/floor,/mob/living/simple_animal/hostile/retaliate/spaceman,/turf/open/floor/plasteel/maniac,/area/science/xenobiology{requires_power = 0; name = "Secret Lab"})
"WJ" = (/obj/effect/mob_spawn/human/orc/corpse/savageorc2,/turf/open/transparent/glass,/area/rogue)
"WS" = (/obj/effect/decal/cleanable/blood/old,/mob/living/simple_animal/hostile/retaliate/spaceman,/mob/living/simple_animal/hostile/retaliate/spaceman,/turf/open/floor/plasteel/maniac,/area/science/xenobiology{requires_power = 0; name = "Secret Lab"})
"WW" = (/mob/living/simple_animal/hostile/retaliate/rogue/orc/spear,/turf/open/floor/rogue/naturalstone,/area/rogue)
"Xy" = (/obj/item/pickaxe/mini,/obj/item/pickaxe/mini{pixel_x = -6},/obj/structure/rack,/turf/open/floor/plasteel/maniac,/area/science/xenobiology{requires_power = 0; name = "Secret Lab"})
"XB" = (/obj/effect/decal/cleanable/blood/gibs/old,/mob/living/simple_animal/hostile/retaliate/spaceman,/mob/living/simple_animal/hostile/retaliate/spaceman,/turf/open/floor/plasteel/maniac,/area/science/xenobiology{requires_power = 0; name = "Secret Lab"})
"XM" = (/obj/structure/showcase/horrific_experiment,/mob/living/simple_animal/hostile/retaliate/spaceman,/mob/living/simple_animal/hostile/retaliate/spaceman,/turf/open/floor/plasteel/maniac,/area/science/xenobiology{requires_power = 0; name = "Secret Lab"})
"Ym" = (/obj/effect/mob_spawn/human/orc/corpse/savageorc,/turf/open/floor/plasteel/maniac,/area/rogue)
"YL" = (/obj/structure/table/greyscale,/turf/open/floor/plasteel/maniac,/area/science/xenobiology{requires_power = 0; name = "Secret Lab"})
"YQ" = (/obj/structure/stairs{dir = 4; icon_state = "stairs"},/turf/open/floor/plating/ashplanet/rocky,/area/rogue)
"Ze" = (/turf/open/floor/plasteel/maniac,/area/rogue)
"Zg" = (/obj/structure/stairs{dir = 4; icon_state = "stairs"},/turf/open/floor/plasteel/maniac,/area/science/xenobiology{requires_power = 0; name = "Secret Lab"})
"ZE" = (/obj/structure/closet/crate/chest/lootbox,/obj/effect/spawner/lootdrop/roguetown/dungeon/spells,/obj/effect/spawner/lootdrop/roguetown/dungeon/misc,/obj/effect/spawner/lootdrop/roguetown/dungeon/misc,/obj/effect/spawner/lootdrop/roguetown/dungeon/food,/turf/open/floor/plasteel/maniac,/area/rogue)

(1,1,1) = {"
zgzgzgzgzgzgzgzgzgzgzgzgzgzgzgzgzgzgzgzg
zgzgzgzgzgzgzgzgzgzgzgzgzgzgzgzgzgzgzgzg
zgzgzgzgzgzgzgzgzgzgzgzgzgzgzgzgzgzgzgzg
zgzgzgzgzgzgzgzgzgzgzgzgzgzgzgzgzgzgzgzg
zgzgzgzgzgzgzgzgzgzgzgzgzgzgzgzgzgzgzgzg
zgzgzgzgzgzgzgzgzgzgzgzgzgzgzgzgzgzgzgzg
zgzgzgzgzgzgzgzgzgzgzgzgzgzgzgzgzgzgzgzg
zgzgzgzgzgzgzgzgzgzgzgzgzgzgzgzgzgzgzgzg
zgzgzgzgzgzgzgzgzgzgzgzgzgzgzgzgzgzgzgzg
zgzgzgzgzgzgzgzgzgzgzgzgzgzgzgzgzgzgzgzg
zgzgzgzgzgzgzgzgzgzgzgzgzgzgzgzgzgzgzgzg
zgzgzgzgzgzgzgzgzgzgzgzgzgzgzgzgzgzgzgzg
zgzgzgzgzgzgzgzgzgzgzgzgzgzgzgzgzgzgzgzg
zgzgzgzgzgzgzgzgzgzgzgzgzgzgzgzgzgzgzgzg
zgzgzgzgzgzgzgzgzgzgzgzgzgzgzgzgzgzgzgzg
zgzgzgzgzgzgzgzgzgzgzgzgzgzgzgzgzgzgzgzg
zgzgzgzgzgzgzgzgzgzgzgzgzgzgzgzgzgzgzgzg
zgzgzgzgzgzgzgzgzgzgzgzgzgzgzgzgzgzgzgzg
zgzgzgzgzgzgzgzgzgzgzgzgzgzgzgzgzgzgzgzg
zgzgzgzgzgzgzgzgzgzgzgzgzgzgzgzgzgzgzgzg
"}
(1,1,2) = {"
jqjqjqjqjqjqzgzgzgzgjqjqjqjqjqjqjqjqjqjq
jqjqjqjqjqjqjqjqjqjqjqCFkCjqFjbZcrbZkCjq
jqjqfukCkCkCkCkCkCkCkCkCkCoFkCkCkCkCkCjq
jqjqfuKnjqjqjqjqdDjqjqjqjqjqgZdnsbgZgZjq
jqjqkCkCZgjqPEkCdmkCLFbTaqjqgZgZsbgZgZjq
jqjqdwkCZgjqgosbMRkCxKixTljqgZgZkCdngZjq
jqjqjqjqjqjqkCiGjqLJjqjqjqjqjqjqoFmPjqjq
jqYLYLcgjqgYzdbejqCERaXyjqDskCjqkCkCEwjq
jqhuSakCjqkDkCPEjqvTkCkCjqfykCjqkCbZsnjq
jqdmAEkCoFPEbeRJuEjqoFjqjqkCkCjqkCkCOrjq
jqYLPEgojqGMzdvUsbGMmWkCpTvUmVjqkCkCqwjq
jqgZsbewjqjqjqjqjqjqjqjqxKoFjqjqkCbZfXjq
jqMXkCkCjqCFPEkCmWvUkCPEkCPECFjqkCkCxqjq
jqYLPEPEoFmWbZPtkCkCkCEPkCGmkCkCkCkCPrjq
jqgZbZGMjqjqjqjqjqjqjqjqjqjqjqjqkCbZnLjq
jqhrhXPEjqXMXMXMDjDjDjDjDjjqkCoFkCglIAjq
jqCibZYLjqCICPJSNNORcAVHtgjqlindGMkCkCjq
jqgZPEgZjqGqXBWSOROhusORusoFkCjqCFbZkCjq
jqjqjqjqjqGhGhGhGhGhGhGhGhGhGhGhGhGhjqjq
jqjqjqjqjqjqjqjqjqjqjqjqjqjqjqjqjqjqjqjq
"}
(1,1,3) = {"
zJzJzJzJzJzJzJzJzJzJzJzJzJzJzJzJzJzJzJzJ
zJzJzJzJzJzJzJzJzJzJzJFAFAFAFAFAzJzJzJzJ
zJzJFAFAFAFAFAFAFAFAFAFAFAFAFAFAFAzJzJzJ
zJFAFAFAFAFAFAFAFAFAFAFAFAFAFAFAFAFAzJzJ
zJFAFAKYKYYQFAFAFAFAFAFAKYsEFCFAFAFAFAzJ
zJFAFAKYKYYQFAFAFAFAFAFAKYsEFCFAFAFAFAzJ
zJFAFAFAFAFAFAFAFAFAFAFAFAFAFCFAFAFAFAzJ
zJFAFAFAFAFAFAFAFAFAFAFAFAFAFCFAFAFAFAzJ
zJFAFAFAFAuPsAoHFCFAFAFAFAkqFCFCFAFAzJzJ
zJFAFAFAuPuPFCFCFCFAFAFAFAFCkqFCFAFAzJzJ
zJzJFAuPuPuPgJgJFCFCFAFAFAWWFCFCFAFAzJzJ
zJzJFAuPuPFCFCFCFCFCFCFCFCFCFCFCFAFAzJzJ
zJzJFAFAUyFCFCFCFCFCFCFCFCFCyqFCFAFAzJzJ
zJzJFAFAUyFCFCFCFCFCFCFCFCFCFCFCFAFAzJzJ
zJzJFAFAUyFCFCFAFAFAFAFCFCSQFCFCFAFAzJzJ
zJzJFAFAFAFAFCFCFAFAFAFCFCFCFCFCFAFAzJzJ
zJFAFAFAFAFAFCFAFAFAFAFAFAFAFAFAFAFAzJzJ
zJFAFAFAFAFAFCFAFAFAFAFAFAFAFAFAFAzJzJzJ
zJzJFAFAFAzJzJFAFAzJzJzJzJzJzJzJzJzJzJzJ
zJzJzJzJzJzJzJzJzJzJzJzJzJzJzJzJzJzJzJzJ
"}
(1,1,4) = {"
KYKYKYKYKYKYKYKYKYKYKYKYKYKYKYKYKYKYKYKY
KYKYKYKYKYKYKYKYKYKYKYKYKYKYKYKYKYKYKYKY
KYKYFAFAFAFAFAFAFAFAFAFAFAFAFAFAFAFAKYKY
KYKYFAFATQTQTQTQTQTQTQFAFAFAFAFAFAFAKYKY
KYKYFAFATQKYcPZeZeZeTQFAFAFAFAFAFAFAKYKY
KYKYFAFATQKYcPZeZeYmTQFAFAFAFAFAFAFAKYKY
KYKYFATQTQTQTQTQZeTQTQFAFAFAFAFAFAFAKYKY
KYKYFATQzpjTZeawZeTQFAFAFAFAFAFAFAFAFAKY
KYKYFATQzpZeZeTQTQTQTQTQTQTQTQTQTQTQFAKY
KYKYFATQzpZetfzpzpzpzpzpzpzpTQZEZeTQFAKY
KYKYFATQzpsmZeQqfTEafTfTfTfTTQMtZeTQFAKY
KYKYFATQWJBoezPqBoezBoezBoBoTQwKZeTQFAKY
KYKYFATQBoBoFBBoezQyPqBoBoFVHGZeZeTQFAKY
KYKYFATQBoFBBoazOTbaezBoBoBoTQdvZeTQFAKY
KYKYFATQfTQqfTfTfTfTEafTfTfTTQTQTQTQFAKY
KYKYFATQzpzpzpzpzpzpzpzpzpzpTQFAFAFAFAKY
KYKYFATQTQTQTQTQTQTQTQTQTQTQTQFAFAFAFAKY
KYKYFAFAFAFAFAFAFAFAFAFAFAFAFAFAFAFAKYKY
KYKYFAFAFAKYKYFAFAFAFAFAFAFAFAFAFAFAKYKY
KYKYKYKYKYKYKYKYKYKYKYKYKYKYKYKYKYKYKYKY
"}
(1,1,5) = {"
KYKYKYKYKYKYKYKYKYKYKYKYKYKYKYKYKYKYKYKY
KYKYKYKYKYKYKYKYKYKYKYFCFCFCFCFCKYKYKYKY
KYKYFCFCFCFCFCFCFCFCFCFCFCFCFCFCFCFCKYKY
KYFCFCFCFCFCFCFCFCFCFCFCFCFCFCFCFCFCKYKY
KYFCFCFCFCFCFCFCFCFCFCFCFCFCFCFCFCFCFCKY
KYFCFCFCFCFCFCFCFCFCFCFCFCFCFCFCFCFCFCKY
KYFCFCFCFCFCFCFCFCFCFCFCFCFCFCFCFCFCFCKY
KYFCFCFCFCFCFCFCFCFCFCFCFCFCFCFCFCFCFCKY
KYFCFCFCFCFCFCFCFCFCFCFCFCFCFCFCFCFCKYKY
KYFCFCFCFCFCFCFCFCFCFCFCFCFCFCFCFCFCKYKY
KYKYFCFCFCFCFCFCFCFCFCFCFCFCFCFCFCFCKYKY
KYKYFCFCFCFCFCFCFCFCFCFCFCFCFCFCFCFCKYKY
KYKYFCFCFCFCFCFCFCFCFCFCFCFCFCFCFCFCKYKY
KYKYFCFCFCFCFCFCFCFCFCFCFCFCFCFCFCFCKYKY
KYKYFCFCFCFCFCFCFCFCFCFCFCFCFCFCFCFCKYKY
KYKYFCFCFCFCFCFCFCFCFCFCFCFCFCFCFCFCKYKY
KYFCFCFCFCFCFCFCFCFCFCFCFCFCFCFCFCFCKYKY
KYFCFCFCFCFCFCFCFCFCFCFCFCFCFCFCFCFCKYKY
KYKYFCFCFCKYKYFCFCKYKYKYKYKYKYKYKYKYKYKY
KYKYKYKYKYKYKYKYKYKYKYKYKYKYKYKYKYKYKYKY
"}
